11111111111111
1PC00000000C01
10001111110001
10000CC0000001
111111111110C1
100C00000C1001
1E0001C0000001
11111111111111
